NO ./path_to_the_north_texture
SO ./path_to_the_south_texture
WE ./path_to_the_west_texture
EA ./path_to_the_east_texture

F 0,255,255
C 0,204,102


1111111111
1100000011
1000N00001
1000000001
1111111111
